0 0 0 0 0 0 0 0 0 0 0 0 0 0 0 0 0 0 0 0 0 0 0 0 0 0 0 0 0 0 0 0 0 0 0 0 0 0 0 0 0 0 
0 0 0 0 0 0 0 0 0 0 0 0 0 0 0 0 0 0 0 0 0 0 0 0 0 0 0 0 0 0 0 0 0 0 0 0 0 0 0 0 0 0
0 0 0 0 0 0 0 0 0 0 0 0 0 0 0 0 0 0 0 0 0 0 0 0 0 0 0 0 0 0 0 0 0 0 0 0 0 0 0 0 0 0
0 0 0 1 1 1 1 1 1 1 1 1 1 0 1 1 1 1 2 2 1 2 1 2 1 1 1 1 1 1 0 1 1 1 1 1 1 1 1 0 0 0
0 0 0 1 2 2 2 1 2 1 2 1 1 311 1 1 2 1 1 1 1 2 1 2 1 2 2 2 1 1 312 1 1 1 1 1 1 4 1 0 0 0
0 0 0 1 1 1 1 1 2 1 2 1 1 0 1 1 2 1 2 2 1 1 1 1 1 2 1 1 1 1 0 1 1 1 1 1 1 1 1 0 0 0
0 0 0 1 2 2 0 0 0 0 0 0 0 0 0 0 0 0 0 0 0 0 0 0 0 0 0 0 0 0 0 0 0 0 0 0 0 0 0 0 0 0
0 0 0 1 2 1 0 0 0 0 0 0 0 0 0 0 0 0 0 0 0 0 0 0 0 0 0 0 0 0 0 0 0 0 0 0 0 0 0 0 0 0
0 0 0 1 2 1 1 2 1 1 1 1 1 1 0 1 1 1 1 1 2 1 2 1 1 1 1 0 1 1 1 1 1 2 1 1 2 1 1 0 0 0
0 0 0 1 2 1 1 2 1 2 2 2 1 1 310 1 1 2 1 1 2 1 2 2 2 1 1 39 1 1 2 1 1 2 1 1 2 2 1 0 0 0
0 0 0 1 1 1 1 1 1 1 1 2 1 1 0 1 1 2 1 1 1 1 1 1 2 1 1 0 1 1 2 1 1 1 1 1 1 1 1 0 0 0
0 0 0 0 0 0 0 0 0 0 0 0 0 0 0 0 0 0 0 0 0 0 0 0 0 0 0 0 0 0 0 0 0 0 0 0 1 2 1 0 0 0
0 0 0 0 0 0 0 0 0 0 0 0 0 0 0 0 0 0 0 0 0 0 0 0 0 0 0 0 0 0 0 0 0 0 0 0 1 1 1 0 0 0
0 0 0 0 0 0 0 0 0 0 0 0 0 0 0 0 0 0 0 0 0 0 0 0 0 0 0 0 0 0 0 0 0 0 0 0 0 38 0 0 0 0 
0 0 0 0 0 0 0 0 0 0 0 0 0 0 0 0 0 0 0 0 0 0 0 0 0 0 0 0 0 0 0 0 0 0 0 0 1 1 1 0 0 0
0 0 0 0 0 0 0 0 0 0 0 0 0 0 0 0 0 0 0 0 0 0 0 0 0 0 0 0 0 0 0 0 0 0 0 0 1 1 1 0 0 0
0 0 0 1 1 1 1 2 1 0 1 1 2 1 1 1 1 1 2 1 1 1 1 1 2 1 1 1 1 0 1 1 1 1 2 2 1 2 1 0 0 0
0 0 0 1 1 1 1 2 1 36 1 2 2 1 1 2 1 1 2 1 2 2 1 1 2 1 2 2 1 37 1 1 2 1 1 2 1 2 1 0 0 0
0 0 0 2 2 1 1 1 1 0 1 1 1 1 1 2 1 1 1 1 1 2 1 1 1 1 1 1 1 0 1 1 2 1 1 1 1 1 1 0 0 0
0 0 0 1 1 1 0 0 0 0 0 0 0 0 0 0 0 0 0 0 0 0 0 0 0 0 0 0 0 0 0 0 0 0 0 0 0 0 0 0 0 0 
0 0 0 2 2 1 0 0 0 0 0 0 0 0 0 0 0 0 0 0 0 0 0 0 0 0 0 0 0 0 0 0 0 0 0 0 0 0 0 0 0 0
0 0 0 1 1 1 0 0 0 0 0 0 0 0 0 0 0 0 0 0 0 0 0 0 0 0 0 0 0 0 0 0 0 0 0 0 0 0 0 0 0 0 
0 0 0 1 2 1 0 0 0 0 0 0 0 0 0 0 0 0 0 0 0 0 0 0 0 0 0 0 0 0 0 0 0 0 0 0 0 0 0 0 0 0
0 0 0 1 2 1 1 1 1 0 1 1 1 1 1 2 1 1 1 1 1 1 1 2 1 1 0 1 1 1 2 1 1 2 1 1 1 1 1 0 0 0
0 0 0 1 2 2 1 2 1 35 1 1 2 2 1 2 2 2 1 2 2 2 1 2 2 1 34 1 2 1 2 2 1 2 1 2 1 1 1 0 0 0
0 0 0 1 1 1 1 2 1 0 1 1 1 1 1 1 1 2 1 2 1 1 1 1 1 1 0 1 1 1 1 1 1 1 1 2 2 2 1 0 0 0
0 0 0 0 0 0 0 0 0 0 0 0 0 0 0 0 0 0 0 0 0 0 0 0 0 0 0 0 0 0 0 0 0 0 0 0 1 1 1 0 0 0
0 0 0 0 0 0 0 0 0 0 0 0 0 0 0 0 0 0 0 0 0 0 0 0 0 0 0 0 0 0 0 0 0 0 0 0 2 2 1 0 0 0 
0 0 0 0 0 0 0 0 0 0 0 0 0 0 0 0 0 0 0 0 0 0 0 0 0 0 0 0 0 0 0 0 0 0 0 0 1 1 1 0 0 0 
0 0 0 0 0 0 0 0 0 0 0 0 0 0 0 0 0 0 0 0 0 0 0 0 0 0 0 0 0 0 0 0 0 0 0 0 2 1 1 0 0 0 
0 0 0 1 1 1 1 2 1 1 1 1 2 1 1 1 1 0 1 1 1 1 1 1 1 2 2 2 1 1 1 2 1 0 1 2 1 2 1 0 0 0
0 0 0 2 2 2 1 2 1 2 1 1 2 1 2 2 1 32 1 1 2 1 2 2 1 2 1 1 1 1 1 2 1 33 1 2 1 2 1 0 0 0
0 0 0 1 1 1 1 1 1 2 1 1 1 1 1 1 1 0 1 1 2 1 1 2 1 2 1 1 2 2 1 1 1 0 1 1 1 1 1 0 0 0
0 0 0 1 2 2 0 0 0 0 0 0 0 0 0 0 0 0 0 0 0 0 0 0 0 0 0 0 0 0 0 0 0 0 0 0 0 0 0 0 0 0
0 0 0 1 1 1 0 0 0 0 0 0 0 0 0 0 0 0 0 0 0 0 0 0 0 0 0 0 0 0 0 0 0 0 0 0 0 0 0 0 0 0 
0 0 0 1 2 2 0 0 0 0 0 0 0 0 0 0 0 0 0 0 0 0 0 0 0 0 0 0 0 0 0 0 0 0 0 0 0 0 0 0 0 0
0 0 0 1 1 2 1 1 1 1 1 1 2 1 1 1 2 1 1 2 1 0 1 1 1 1 1 1 2 1 1 1 1 1 1 1 1 1 1 0 0 0
0 0 0 1 1 2 2 2 1 2 1 1 2 1 1 2 2 2 1 2 1 31 1 2 1 2 2 1 2 1 2 1 1 2 1 1 1 5 1 0 0 0 
0 0 0 1 1 1 1 1 1 2 1 1 1 1 1 1 1 1 1 2 1 0 1 2 1 1 1 1 1 1 1 1 1 2 1 1 1 1 1 0 0 0
0 0 0 0 0 0 0 0 0 0 0 0 0 0 0 0 0 0 0 0 0 0 0 0 0 0 0 0 0 0 0 0 0 0 0 0 0 0 0 0 0 0
0 0 0 0 0 0 0 0 0 0 0 0 0 0 0 0 0 0 0 0 0 0 0 0 0 0 0 0 0 0 0 0 0 0 0 0 0 0 0 0 0 0
0 0 0 0 0 0 0 0 0 0 0 0 0 0 0 0 0 0 0 0 0 0 0 0 0 0 0 0 0 0 0 0 0 0 0 0 0 0 0 0 0 0






